16 16 16 16 16 16 16 16 16 16 16 16 16 16 16 16
16 16 16 16 16 16 16 00 03 04 16 16 16 16 16 16
16 16 16 16 16 16 16 40 11 44 16 16 16 16 16 16
16 16 16 16 16 16 16 46 51 46 16 16 16 16 16 16
16 16 16 16 16 16 16 16 51 16 16 16 16 16 16 16
16 16 16 16 16 16 16 36 51 37 16 16 16 16 16 16
16 16 16 16 16 16 16 46 51 46 16 16 16 16 16 16
16 16 16 16 16 16 16 16 51 16 16 16 16 16 16 16
16 16 16 16 16 16 16 16 51 16 16 16 16 16 16 16
16 16 16 16 16 16 16 36 51 37 16 16 16 16 16 16
16 16 16 16 16 16 16 46 51 46 16 16 16 16 16 16
16 16 16 16 16 16 16 47 51 16 16 16 16 16 16 16
16 16 16 16 16 16 16 80 17 16 16 16 16 16 16 16
16 16 16 16 16 16 16 25 27 16 16 16 16 16 16 16
16 16 16 16 16 16 16 46 46 16 16 16 16 16 16 16
16 16 16 16 16 16 16 16 16 16 16 16 16 16 16 16
