10 07 01 09 02 1
10 08 03 08 13 1
10 07 13 07 13 1
10 07 09 09 09 1
10 07 05 09 05 1
