16 16 16 16 16 16 16 16 16 16 16 16 16 16 16 16
16 16 47 16 16 16 16 16 16 16 16 16 16 16 16 16
16 16 80 16 16 16 16 16 16 36 06 37 16 16 16 16
16 00 11 04 16 16 16 16 16 38 87 38 16 16 16 16
16 20 22 34 16 16 16 16 16 10 22 14 16 16 16 16
16 40 33 44 16 16 16 16 16 30 22 34 16 16 16 16
16 87 51 87 16 16 16 16 16 40 22 44 16 16 16 16
16 46 15 46 16 16 16 16 16 46 17 46 16 16 16 16
16 16 25 06 07 16 16 16 16 16 15 16 16 16 16 16
16 16 46 46 17 16 16 16 16 16 17 16 16 16 16 16
16 16 16 00 22 04 16 16 16 16 17 16 16 16 16 16
16 16 16 20 22 22 06 26 26 06 27 16 16 16 16 16
16 16 16 40 42 44 46 46 46 46 46 16 16 16 16 16
16 16 16 46 46 46 16 16 16 16 16 16 16 16 16 16
16 16 16 16 16 16 16 16 16 16 16 16 16 16 16 16
16 16 16 16 16 16 16 16 16 16 16 16 16 16 16 16
