16 16 16 16 16 16 16 16 16 16 16 16 16 16 16 16
16 16 16 16 16 16 16 47 16 16 16 16 16 16 16 16
16 16 16 16 16 16 16 38 16 16 16 16 16 16 16 16
16 16 05 06 06 06 06 06 06 06 06 06 07 16 16 16
16 16 15 46 46 46 46 46 46 46 46 46 15 16 16 16
16 16 15 16 16 36 26 26 26 37 16 16 15 16 16 16
16 16 15 16 16 98 80 90 98 98 16 16 15 16 16 16
16 16 15 16 16 00 01 88 03 04 16 16 15 16 16 16
16 16 25 26 26 21 11 88 33 13 26 26 27 16 16 16
16 16 46 46 46 40 41 88 42 44 46 46 46 16 16 16
16 16 16 16 16 46 46 75 46 46 16 16 16 16 16 16
16 16 16 16 16 16 16 16 16 16 16 16 16 16 16 16
16 16 16 16 16 16 16 16 16 16 16 16 16 16 16 16
16 16 16 16 16 16 16 16 16 16 16 16 16 16 16 16
16 16 16 16 16 16 16 16 16 16 16 16 16 16 16 16
16 16 16 16 16 16 16 16 16 16 16 16 16 16 16 16
