20 6 4 9 4
1D 8 5 8 5
10 6 6 9 8
1A 6 5 6 5
2B 6 5 6 5
